

  111111  11    11    1111   11    11
  111111  11    11   11  11  11   11
  11      11    11  11   11  11  11
  11      11    11  11       11 11
  11111   11    11  11       1111
  11111   11    11  11       1111
  11      11    11  11       11 11
  11      11    11  11   11  11  11
  11       11  11    11  11  11   11
  11        1111      1111   11    11


  2222222222222222   2222222222222222
  2222222222222222   2222222222222222





















                  1111
                  13 1
                  1  1